- - # # - # # # - - - - # # #
- S # # - - # - - - - - # # #
- - # - - - - - - - # - - # #
- - - - - - # # # # # - - - #
# - - - - # # - - - - - # - #
# - - - # # - - - # # # # - #
# - - # # # - - - # # # # - -
# - - # # # - - # # # # # - -
# - - # # # - - # - E # # - -
# - - - # # # - - - # # # - #
# - - - - # # - - # # # # - #
- - # - - - # # - - # # # - #
- - # # - - # # # - - # # - #
- - # # # - # # # # - - # - -
- - # # # - - - - - - - - - -