- S - - # # # - - - - - - # # # # # - - - - - - - - - - - -
- - - - - - - - # - # - - - - - - - - - - - - - - - - - - -
- # # - - - - # # # # # - - # - - - - # - - - - - # - - - -
- - # # - - # # # # # # - # # # - - # # # # - - - # # - - -
- - # - - - # # # # # # - - # # - - - # # # - - - # # # - -
- - - - - - # # # # # # - - # # - - - # # # - - # # # # # #
- - - # - - # # # # # # - - # - - - - # # # - # # # # # # #
- - # # - - # # # # # # # - - - # - - - # - - # # # # - - -
- - # # - - # # # # # # # - - - # # - - # - - # # # - - # -
- - # # - - # # # # # # # - - # # # - - - - - # # - - - # -
- - # # # - # # # # # # # - # # # # - - - - - - - - - - # -
- - # # # - - # # # # # # - # # # # - # # # - - - - # # # -
- - # # # - - - # # # # - - # # # # - - # - - - - - - # # -
# - # # # - - - - - - - - - # # # # - - - - # # - - - # # -
# - # # # - - - # # # # # - - # # # - - # # # # - - - # # -
# - # # - - - # # # # # # # - # # - - - # # # # # - - - # #
# - - # - - - - # # # # # # - # - - - - # # # # # - - - - #
# - - # - - - - # # # # # # - - - - - - # # # # # - - - - -
- - - - - - - - - # # # # # # # # - - - # # # # # - - # # -
- - - # - - - - - - - # # # # # - - - - - # # # # - # # # -
- # # # # - - - - - - # # # # # - - - - - - - # - - # # - -
- # # # # - - # # - - - - - - - - - # - - - - - - - # # - -
- # # # # # - # # # # # # - - - - # # # - - - - - - # - - -
- # # # # # - - # # # # # # - - - # # # - - - - - - # - - -
- # # # # # - - # # # # # # - - - # # # - - - # - - - - - #
- # # # # # - - # # # # # # - - - - # # - - # # - - - - - #
- - # # # # - - - # # # # # - - - - # - - # # # # # - - - #
- - # # # # # - - # # # # - - - - - - - - - # # # # - - # #
- - - # # # # - - - # # - - - - # - - - # - - # # - - # # #
- - - # # # # - - - - # - - - # # # - - # # - E - - - # # #