- S - - # # # - - - - - - # # # # # - - - - - - - - # # # # # - - # # # # # - - - - - - - - - # # #
- - - - - - - - # - # - - - - - - - - - - - - - - - - # # - - - - - - - - - - - - - - - - - - - # #
- # # - - - - # # # # # - - # - - - - # - - - - - # - - - - - # - - # - - - - # - - - - - # - - - #
- - # # - - # # # # # # - # # # - - # # # # - - - # # - - - # # - # # # - - # # # # - - - # # - - -
- - # - - - # # # # # # - - # # - - - # # # - - - # # # - - # # - - # # - - - # # # - - - # # # - -
- - - - - - # # # # # # - - # # - - - # # # - - # # # # # # # # - - # # - - - # # # - - # # # # # #
- - - # - - # # # # # # - - # - - - - # # # - # # # # # # # # # - - # - - - - # # # - # # # # # # #
- - # # - - # # # # # # # - - - # - - - # - - # # # # - # # # # # - - - # - - - # - - # # # # - - -
- - # # - - # # # # # # # - - - # # - - # - - # # # - - # # # # # - - - # # - - # - - # # # - - # -
- - # # - - # # # # # # # - - # # # - - - - - # # - - - # # # # # - - # # # - - - - - # # - - - # -
- - # # # - # # # # # # # - # # # # - - - - - - - - - - # # # # # - # # # # - - - - - - - - - - # -
- - # # # - - # # # # # # - # # # # - # # # - - - - # # # # # # # - # # # # - # # # - - - - # # # -
- - # # # - - - # # # # - - # # # # - - # - - - - - - # # # # # - - # # # # - - # - - - - - - # # -
# - # # # - - - - - - - - - # # # # - - - - # # - - - # # # # - - - # # # # - - - - # # - - - # # -
# - # # # - - - # # # # # - # # # # - - # # # # - - - # # # # # # - # # # # - - # # # # - - - # # -
# - # # - - - # # # # # # # - # # - - - # # # # # - - - # # # # # # - # # - - - # # # # # - - - # #
# - - # - - - - # # # # # # - # - - - - # # # # # - - - - # # # # # - # - - - - # # # # # - - - - #
# - - # - - - - # # # # # # - - - - - - # # # # # - - - - - # # # # - - - - - - # # # # # - - - - -
- - - - - - - - - # # # # # # # # - - - # # # # # - - # # - # # # # # - - - - - # # # # # - - # # -
- - - # - - - - - - - # # # # # - - - - - # # # # - # # # - - # # # # # - - - - - # # # # - # # # -
- # # # # - - - - - - # # # # # - - - - - - - # - - # # - - - # # # # # - - - - - - - # - - # # - -
- # # # # - - - - - - - - - - - - - # - - - - - - - # # - - - # # # - - - - - - - - - - - - # # - -
- # # # # # - # # # # # # # - - - # # # - - - - - - # - - - # # # # - - - # - - - - - - - - # - - -
- # # # # # - - # # # # # # - - - # # # - - - - - - # - - - # # # # - # # # - - - - - - - - # - - -
- # # # # # - - # # # # # # - - - # # # - - - # - - - - - # # # # # - - # # - - - - - # - - - - - #
- # # # # # - - # # # # # # - - - - # # - - # # - - - - - # # # # # - - # # - - - - # # - - - - - #
- - # # # # - - - # # # # # - - - - # - - # # # # # - - - # # # # # - - - # - - - # # # # # - - - #
- - # # # # # - - # # # # # - - - - - - - # # # # # - - # # # # # # - - - - - - - # # # # # - - # #
- - - # # # # - - - # # - - - - # - - - # # # # # - - # # # # # - - - - # - - - # # # # # - - # # #
- - - # # # # - - - - # - - - # # # - - # # - - - - - # # # # # - - - # # # - - # # - - - - - # # #
- - # # - - # # # # # # # - - # # # - - - - - # # # - - - # # # # - - # # # - - - - - # # - - - # -
- - # # # - # # # # # # # - # # # # - - - - - - # - - - - - # # # - # # # # - - - - - - - - - - # -
- - # # # - - # # # # # # - # # # # - # # # - - - - # # - - # # # - # # # # - # # # - - - - # # # -
- - # # # - - - # # # # - - # # # # - - # - - - - - - # # - - # - - # # # # - - # - - - - - - # # -
# - # # # - - - - - - - - - # # # # - - - - # # - - - # # - - - - - # # # # - - - - # # - - - # # -
# - # # # - - - # # # # # - # # # # - - # # # # - - - # # - - - # - # # # # - - # # # # - - - # # -
# - # # - - - # # # # # # # - # # - - - # # # # # - - # # # - # # # - # # - - - # # # # # - - - # #
# - - # - - - - # # # # # # - # - - - - # # # # # - # # # # - # # # - # - - - # # # # # # - - - - #
# - - # - - - - # # # # # # - - - - - - # # # # # # # # # # - # # # - - - - - - # # # # # - - - - -
- - - - - - - - - # # # # # # # # - - - # # # # # # # # # # - # # # # # # - - - # # # # # - - # # -
- - - # - - - - - - - # # # # # - - - - - # # # # # # # # - - # # # # # - - - - - # # # # - # # # -
- # # # # - - - - - - # # # # # - - - - - - - # # # # - - - - - # # # # - - - - - - - # - - # # - -
- # # # # - - - - - - - - - - - - - # - - - - - - # # - - - - - # - - - - - - - # - - - - - # # - -
- # # # # # - # # # # # # # - - - # # # - - - - - # # - - - - # # - - - # # - # # - - - - - # - - -
- # # # # # - - # # # # # # - - - # # # - - - - # # # - - - # # # # - # # # - # # - - - - - # - - -
- # # # # # - - # # # # # # - - - # # # - - - # # # - - - # # # # # - # # # - # # - - # - - - - - #
- # # # # # - - # # # # # # - - - - # # - - # # # # - - - # # # # # - - # - - # - - # # - - - - - #
- - # # # # - - - # # # # # - - - - # - - # # # # # - - - E # # # # - - # - - - - # # # # # - - - #
- - # # # # # - - # # # # # - - - - - - - # # # # # - - - - - - # - - - - - - - - # # # # # - - # #
- - - # # # # - - - # # - - - - # - - - # # # # # - - - - - - - - - - - # # - - # # # # # - - # # #